R 60 60

NO ./textures/barrel.xpm
SO ./textures/blue_stone.xpm
WE ./textures/gold_block.xpm
EA ./textures/red_wool.xpm

S ./textures/sprite.xpm

F 60,165,115
C 225,255,255



        1111111111111111111111111
        1000000000110000000000001
        1011000001110000002000001
        1001000000000000000000001
111111111011000000000000000000001
100000000000000000000000000111111
100E0000000000000000000000001
10000000000000000000000000001
11000000000000000000000000001
10000000000000000000000000001
10000000000000001101010010001
1100000111010101111101111000111
11110111 1110101 101111010001
11111111 1111111 111111111111
