R 3000 3000

NO ./textures/sprite.xpm
SO ./textures/blue_stone.xpm
WE ./textures/gold_block.xpm
EA ./textures/red_wool.xpm

S ./textures/barrel.xpm

F 60,165,115
C 95,125,26



111111111111111111111111111111111111111111111111111111111111111111111111111111111111
100000000000000000000000000000000000000000000000000000000000000000200000000000000001
100000000000000000000000000000000000000000000000000000000000000000200000000000000001
100000000000000000000000000000000000000000000000000000000000000000200000000000000001
100000000000000000000000000000000000000000000000000000000000000000200000000000000001
100000000000000000000000000000000000000000000000000000000000000000200000000000000001
100000000000000000000000000000000000000000000000000000000000000000200000000000000001
100000000000000000000000000000000000000000000000000000000000000000200000000000000001
100000000000000000000000000000000000000000000000000000000000000000200000000000000001
100000000000000000000000000000000000000000000000000000000000000000200000000000000001
100000000000000000000000000000000000000000000000000000000000000000200000000000000001
100000000000000000000100000000000000000000000000000000000000000000000000000000000001
100000000000000000000100000000000000000000000000000000000000000000000000000000000001
100000000000000000000100000000000000000000000000000000222200000000000000000000000001
100000000000000000000100000000000000000000000000000000000000000000000000000000000001
100000000000000000000100000000000000000000000000000000000000000000000000000000000001
100000000000000000000100000000000000000000000000000000000000000000222220000000000001
100000000000000000000100000000000000000000000000000000000000000000000000000000000001
100000000000000000000100000000000000000000000000000000000000000000000000000000000001
100000000000000000000000000000000001000000000000000000222220000000000000000000000001
100200000000000000000100000000000000000000000000000000000000000000000000000000000001
100000000000000000000100000000000000000000000000000000000000000000000000000000000001
100000000000000000000000000000000000000000000000000000000000000000000000000000000001
100000000000000000000100000000000000000000000000000000000000000000000000000000000001
100000000000000000000100000000001000000000000000011111111111111111111111111111111111
100000000000000000000000000000000000000000000000000000000000001000000000000000000001
100000000000000000000000000000000000000000000000000000000000000000000000000000000001
100000000000000000000222222000000000000000000000000000000000000000000000000000000001
100000000000000000000000000000000000000000000000011111111111111111000000000000000001
100000000000000000000000000000000000000000000000000000000000000000000000000000000001
100000000000000000000000000000000000000000000000000000000000000000000000000000000001
100000000000000000000000000222222222000000000000000000000000000000000000000000000001
100000000000000000000000000000000000000000000000000000000000000000000000000020000001
100000000000000000000000000000000000000000000000000000000000000000000000000000000001
100000000000200000000000000000000000000000000000000000000000000000000000000002000001
100000000000000000000000000000000000000000000000000000000000000000000000000000000001
100000000000000000000000000000000000000000000002222200000000000000000000000000000001
10000000000000200000000000000000000N000000000000000000000000000000000000000000000001
100000000000000000000000000000000000000000000000000000000000000000000000000000000001
100000000000000000000000000000000000000000000000000000000000000000000002000000000001
100000000000000000000000000000000000000000000000000000000000000000000000000000000001
111111111111111111111111111111111111111111111111111111111111111111111111111111111111
