R 3000 3000

NO ./textures/grocha.xpm
SO ./textures/forest2.xpm
WE ./textures/forest1.xpm
EA ./textures/pouet.xpm

S ./textures/chatfeu.xpm

F 60,45,36
C 40,100,80



        1111111111111121111111111
        2000000000110000000020001
        1011000001110000000000001
        1001000000000000000000001
        1001000000000000000000001
        1001000000000000000000001
        1N01000000000000000000001
111111111111000000020000000000002
100000000000000000000000000211111
100000000000000000000000000111111
100000000000000000000000000211111
100000000000000000000000000111111
10000000200000000000000000001
10000000000000000000000000001
10000000000000000000000000002
10000000000000000000000000001
10000000000000000000000000001
11000000000000002000000000001
10000000002000000000000000001
10020000000000001101010010001
1100000111010101111101111000111
11111111 1110101 101111010021
11111111 1111111 111111111111
