R 1440 800

NO ./textures/stone.xpm
SO ./textures/blue_stone.xpm
WE ./textures/gold_block.xpm
EA ./textures/red_wool.xpm

S ./textures/barrel.xpm

F 60,165,115
C 225,155,255



        1111111111111111111111111
        1000000000110000000020001
        1011000001110000000000001
        1001000000000000000000001
111111111011000000020000000000001
100000000000000000000000000111111
100E0000000002000000000000001
10000000000000000000000000001
11000000000000002000000000001
10000000002000000000000000001
10000000000000001101010010001
1100000111010101111101111000111
11111111 1110101 101111010021
11111111 1111111 111111111111
