R 1440 800

NO ./textures/coronajc.xpm
SO ./textures/simpsonsbasketball.xpm
WE ./textures/lecri_gjmacron.xpm
EA ./textures/castanerles3.xpm

S ./textures/barrel.xpm

F 60,165,115
C 95,125,26



111111111111111111111111111111111111111111111111111111111111111111111111111111111111
100000000000000000000100000000000000000000000000000000000000000000000000000000000001
100000000000000000000100000000000000000000000000002000000000000000000000000000000001
100000000000000000000000000000000000000000000000000000000000000000000000000000000001
100000000000000000000100000000000001000000000000000000000200000000000000000000000001
100000000000000000000100000000000000000000000000000000000000000000000000000000000001
100000000000000000000000000000001000000000000000000000000000000000000000000000000001
10000000000000000000010000000000100N000000000000000000000010000000000000000000000001
100000000000000000000100000000001000000000000000011111111111111111111111111111111111
100000000000000000000000000000000000000000000000000000000000001000000000000000000001
100000000000000000000000000000000000000020000000000000000000000000000000000000000001
100000000000000000000000000000000000000000000000000000000000000000000000000000000001
100000000000000000000000000000000000000000000000011111111111111111000000000000000001
100000000000000000000000000000000000000000000000000000000000000000000000000000000001
100000000000000000000000000000000000000000000000000000000000000000000000000000000001
100000000000000000000000000000000000000000000000000000000000000000000000000000000001
100000000000000000020000000020000000000000000000000000000000000000000000000000000001
100000000000000000000000000000000000000000000000000000000000000000000000000000000001
100000000000000000000000000000000000000000000000000000000000000000000000000000000001
100000000000000000000000000000000000020000000000000000000000000000000000000000000001
100000000000000000000000000000000000000000000000000000000000000000000000000000000001
100000000000000000000000000000000000000000000000000000000000000000000000000000000001
100000000000000000000000000000000000000000000000000000000000000000000000000000000001
100000000000000000000000000000000000000000000000000000000000000000000000000000000001
100000000000000000000000000000000000000000000000000000000000000000000000000000000001
111111111111111111111111111111111111111111111111111111111111111111111111111111111111
