R 1600 1600

NO ./textures/coronajc.xpm
SO ./textures/simpsonsbasketball.xpm
WE ./textures/lecri_gjmacron.xpm
EA ./textures/castanerles3.xpm

S ./textures/me.xpm

F 60,165,115
C 95,125,26



111111111111111111111111111111111111111122211111111111111111111111111111111111111111
100000000000000000000120000000000000000000000000000000000000000000000000000000000001
100000000020000200000100000000000000000000000000002000000000000000000000000000000001
100000000002002000000000000000000000000000000000000000000000000000000000000000000001
100000000000200000000100000000000001000000000000000000000200000000000000000000000001
100000000000000000000120000000000000000000000000000000000000000000000000000000000001
100000000000000000000000000000001000000000000000000000000000000000000000000000000001
10000000000000000000010000000000100N000000000000000000000010000000000000000000000001
100000000000000000000100000000001000000000000000011111111111111111111111111111111111
100000000000000000000000000000000000000000000000000000000000001000000000000000002001
100000000000000000000000000000000000000020000000000000000000000000000000000000000001
100000000000000000000000000000000000000000000000000000000000000000000000000000000001
100000000000002000000000000000000000000000000000011111111111111111000000000000000001
100000000000000000000000000000000000000000000000000000000000000000000000000000002001
100000000000000000000000000000000000000000000000000000000000000000000000000000222001
100000000000000000000000000000000000000000020000000000000000000000000000000000002001
100000000000000000020000000020000000000000020000000000000000000000000000000000000001
100000000000000000000000000000002222200000020000000000000000002000000000000000000001
100000000000000000000000000000000000000000000000000000000000000000000000000000000001
100000000000000000000000000000000000020000000000000000000000000000000000000000000001
100000000000000000000000000000000000000000000000000000000000020000000000000000000001
100000000000000000000000000000000000000000000000000000000000000000000000000000000001
100000000000000000000000000000000000000000000000000000000000000000200000000000000001
100000000000000000000000000000000000000000000000000000000000000000000000000000000001
100000000000000000000000000000000000000000000000000000000000000002000000000000000001
111111111111111111111111111111111111111111111111111111111111111111111111111111111111
