R 1440 800

NO ./textures/barrel.xpm
SO ./textures/blue_stone.xpm
WE ./textures/gold_block.xpm
EA ./textures/red_wool.xpm

S ./textures/sprite.xpm

F 60,165,115
C 95,125,26



111111111111111111111111111111111111111111111111111111111111111111111111111111111111
100000000000000000000100000000000000000000000000000000000000000000000000000000000001
100000000000000000000100000000000000000000000000000000000000000000000000000000000001
100000000000000000000000000000000001000000000000000000000000000000000000000000000001
100000000000000000000100000000000000000000000000000000000000000000000000000000000001
10000000000000000000010000000000000N000000000000000000000000000000000000000000000001
100000000000000000000000000000000000000000000000000000000000000000000000000000000001
100000000000000000000100000000000000000000000000000000000000000000000000000000000001
100000000000000000000100000000001000000000000000011111111111111111111111111111111111
100000000000000000000000000000000000000000000000000000000000001000000000000000000001
100000000000000000000000000000000000000000000000000000000000000000000000000000000001
100000000000000000000000000000000000000000000000000000000000000000000000000000000001
100000000000000000000000000000000000000000000000011111111111111111000000000000000001
100000000000000000000000000000000000000000000000000000000000000000000000000000000001
100000000000000000000000000000000000000000000000000000000000000000000000000000000001
100000000000000000000000000000000000000000000000000000000000000000000000000000000001
100000000000000000000000000000000000000000000000000000000000000000000000000000000001
100000000000000000000000000000000000000000000000000000000000000000000000000000000001
100000000000000000000000000000000000000000000000000000000000000000000000000000000001
100000000000000000000000000000000000000000000000000000000000000000000000000000000001
100000000000000000000000000000000000000000000000000000000000000000000000000000000001
100000000000000000000000000000000000000000000000000000000000000000000000000000000001
100000000000000000000000000000000000000000000000000000000000000000000000000000000001
100000000000000000000000000000000000000000000000000000000000000000000000000000000001
100000000000000000000000000000000000000000000000000000000000000000000000000000000001
111111111111111111111111111111111111111111111111111111111111111111111111111111111111
