R 1440 800

NO ./textures/brick.xpm
SO ./textures/mozaikbrik.xpm
WE ./textures/wood.xpm
EA ./textures/blackpaper.xpm

S ./textures/sprite.xpm

F 60,65,15
C 25,55,55


                        1111111111111111111111111111111111111
                        1000000000000000000000000000000000001
                        1000000000000000000000000000000000001111
        11111111111111111000000000011111111111111111111110000001
        1000000000000000000000000001                    10000001
        1000000000000000000000000001       1111111      10000001
        1000000000000000000000000001       1000001      10000001
111111111000000000000000000000000001111111111101111111111110000111111
100000001000000000000000000000000000000000000000000000000010000000001
100000001000000000000000000000000000000000000000000000000010000000011
100000001000000000000000000000000000000000000000000000000011111100001
1000W0000000000000000000000000000000000000000000000000000000000100001
100000001000000000000000000000000000000000000000000000000000000100001
100000001000000000000000000000000000000010000000000000000000000100001
100000001000000000000000000000000000000010000000000000000000000100001
111111111111111111111111111111111111111110000000000001111111111100001
                                        10000000000001000000000000001
                                        10000000000000000000000000001
                                        10000000000000000000000000001
                                        11111111111111111111111111111
