R 1600 1600

NO ./textures/blue_stone.xpm
SO ./textures/gold_block.xpm
WE ./textures/stone.xpm
EA ./textures/red_wool.xpm

S ./textures/barrel.xpm

F 60,165,115
C 225,255,255



1111111111
100000001
100000001
100000001
1E0000021
100000001
100000001
100000001
111111111
